19 22
###################
#........#........#
#.##.###.#.###.##.#
#.##.###.#.###.##.#
#.................#
#.##.#.#####.#.##.#
#....#...#...#....#
####.### # ###.####
   #.#   P   #.#   
####.# # # # #.####
    .  #PPP#  .    
####.# ## ## #.####
   #.#       #.#   
####.# ##### #.####
#........#........#
#.##.###.#.###.##.#
#..#.....H.....#..#
##.#.#.#####.#.#.##
#....#...#...#....#
#.######.#.######.#
#.................#
###################

